$$$ exec p1 : [garbage]
Plateau 15 17:
    01234567890123456
SOM .................
EBO .................
DY  .................
ONC .................
E T .................
OLD .................
 ME .................
 TH .................
E W ..O..............
ORL .................
D I .................
S G .................
ONN ..............X..
A R .................
OLL .................
Piece 5 5:
.....
.....
..**.
..*..
.....


